Stage 1
#####
#OoP#
#####
=====
Stage 2
  #######
###  O  ###
#    o    #
# Oo P oO #
###  o  ###
 #   O  #
 ########
====
Stage 3
########
#P     #
#    oO#
#   Oo #
########
====
Stage 4
#####
#P  ###
#Oo0  #
#  #  #
#     #
#######
===
Stage 5
 #####
##P  ##
#  #  #
# o0o #
#  O  #
## O ##
 #####